NO ./assets/bluestone.xpm
SO ./assets/greystone.xpm
WE ./assets/mossy.xpm
EA ./assets/redbrick.xpm
F 220,100,255
C 225,30,0


11111111
10011001
10000011
11000001
10000001
10001001
10000E01
11111111
