NO ./assets/bluestone.xpm
SO ./assets/greystone.xpm
WE ./assets/mossy.xpm
EA ./assets/redbrick.xpm
F 142,95,39
C 15,99,153

1111111111111111111111111
1000000000110000000000001
1011000001110000000000001
1001000000000000000000001
11111111101100000111000001
10000000001100000111011111111
1111011111111100000000010001
11110111111111011101010010001
11000000110101011100000010001
10000000000000001100000010001
10000000000000001101010010001
11000001110101011111010010N11
111101111110101101111010001
111111111111111111111111111
