NO ./assets/greystone.xpm
SO ./assets/redbrick.xpm
WE ./assets/mossy.xpm
EA ./assets/eagle.xpm
F 142,95,39
C 15,99,153

11111111111 1111111111111111111111
1000000000110000000000000000000001
1011000001110000000000000000000001
1001000000000000000000000000000001
1111111110110000010000000000000001
1000000000110000010001000001111001
1111011111111100000000000000010001
111101111111110111E001000000000001
1100000011010101110000000000000001
1000000000000000110000000000000001
1000000000000000110001000000010001
1100000111010100000001000100010011
11110111 1101011000000011100010001
11111111 1111111111111111 11111111
