NO ./assets/bluestone.xpm
SO ./assets/greystone.xpm
WE ./assets/mossy.xpm
EA ./assets/redbrick.xpm
F 142,95,39
C 15,99,153

1111111111111111111111111111111111
1000000000110000000000000000000001
1011000001110000000000000000000001
1001000000000000000000000000000001
1111111110110000011100000000000001
1000000000110000011101000001111001
1111011111111100000000000000010001
1111011111111101110101000000000001
1100000011010101110000000000000001
1000000000000000110000000000000001
1000000000000000110101000000010001
1100000111010101111101000000010N11
1111011111101011011110000000010001
1111111111111111111111111111111111
