NO ./assets/bluestone.xpm
SO ./assets/greystone.xpm
WE ./assets/mossy.xpm
EA ./assets/redbrick.xpm
F 220,100,255
C 225,30,0


1111111111111
10000000011
101110000001111
1010100000000001
100111100000111
110001110001
10001   10001
111001110001
10000N00001
1111111111
