NO ./assets/bluestone.xpm
SO ./assets/greystone.xpm
WE ./assets/mossy.xpm
EA ./assets/redbrick.xpm
F 142,95,39
C 15,99,153

11111111
10011001
10000011
10001001
10000001
1000W001
10001001
11111111
