NO ./assets/bluestone.xpm
SO ./assets/greystone.xpm
WE ./assets/mossy.xpm
EA ./assets/redbrick.xpm
F 220,100,255
C 225,30,0


11111111111111111111111111111111111111111
10000000000000000000000000000000000000001
10000000000000000000000000000000000000001
10000000000000000000000000000000000000001
10000000000000000000000000000000000000001
10000000000000000000011111110000000000001
100000000000000000001       1000000000001
10000000000000000000011111110000000000001
10000000000000000000000000000000000000001
10000000000000000000000000000000000000001
10000000000000000000000000000000000000001
10000000000000000000000000000000000000001
100000000000000000000000000N0000000000001
10000000000000000000000000000000000000001
11111111111111111111111111111111111111111
