NO ./assets/bluestone.xpm
SO ./assets/greystone.xpm
WE ./assets/mossy.xpm
EA ./assets/redbrick.xpm
F 220,100,255
C 225,30,0


1111111111
1000000001
1011100001
1010100001
1001111001
1100000001
1000000001
1110000001
1N00000001
1111111111
