                    NO ./path_to_the_north_texture
		SO ./path_to_the_south_texture
                                               WE ./path_to_the_west_texture
EA           ./path_to_the_east_texture

F 220,100,255


C 225,30,0

     11111111111111
    1000100000000011
     101100000111111
 111111111001000000111111111111
11111111011000001110000000000001
100000000011000001110111111111111
11110111110111011100000010001
11110111111111111101111110001
110000001      1101      10001
10000000011111101101111110001
10000000000000001101010010001
110000011101E10111110111101111
1111011111101011011110100011
110001110101011111011110111
11111111111111111111111111111111111111111

