NO ./assets/eagle.xpm
SO ./assets/greystone.xpm
WE ./assets/mossy.xpm
EA ./assets/redbrick.xpm
F 142,95,39
C 15,99,153


1 1  1 1
      111111111111111111
      10000000001
      111111111111111
      10N001
      1001001
      1111111
