NO ./assets/bookshelf.xpm
SO ./assets/redbrick.xpm
WE ./assets/mossy.xpm
EA ./assets/eagle.xpm
F 142,95,39
C 15,99,153

        1111111111111111111111111
        1000000000110000000000001
        1011000001110000000000001
        1001000000000000000000001
111111111011000001110000000000001
100000000011000001110111111011111
11110111111111011100000010001
11110111111111011101010010001
11000000110101011100000010001
10000000001 10000110000001000111111111111111111
10000000000100001101010010000000000000000000001
11000001110101011111011110W01111111111111111111
11110111 1110101 101111010001
11111111 1111111 111111111111
