NO ./assets/bookshelf.xpm
SO ./assets/redbrick.xpm
WE ./assets/mossy.xpm
EA ./assets/eagle.xpm
F 255,255,255
C 255,255,255

        1111111111111111111111111
        1000000000000000000000001
        1100000000000000000000001
        1000000000000000000000001
111111111000000000000000000000001
100000000000000000000000000001111
10000000000000N10000000000001
11110000000000000000000001001  11
    1000000000000000000000001 1001
11   110000000000000111111111 101
101 1000000000000001   1 11001 1
110100001110101011111      101
11110111 1110111 10111    1001
11111111 1111111 11111    111
